###############################################################################################################################################################################
#                                                                                                                                                                             #
#                                                                                                                                                                             #
#                                                                                                                                                                             #
#                                                                                                                                                                             #
#                                                                                                                                                                             #
#                                                                                                                                                                             #
#                                                                                                                                                                             #
#                                                                                                                                                                             #
#                                                                                                                                                                             #
#                                                                                                                                                                             #
#                                                                                                                                                                             #
#                                                                                                                                                                             #
#                                                                                                                                                                             #
#                                                                                                                                                                             #
#                                                                                                                                                                             #
#                                                                                                                                                                             #
#                                                                                                                                                                             #
#                                                                                                                                                                             #
#                                                                                                                                                                             #
#                                                                                                                                                                             #
#                                                                                                                                                                             #
#                                                                                                                                                                             #
#                                                                                                                                                                             #
#                                                                                                                                                                             #
#                                                                                                                                                                             #
#                                                                                                                                                                             #
#                                                                                                                                                                             #
#                                                                                                                                                                             #
#                                                                                                                                                                             #
#                                                                                                                                                                             #
#                                                                                                                                                                             #
#                                                                                                                                                                             #
#                                                                                                                                                                             #
#                                                                                                                                                                             #
#                                                                                                                                                                             #
#                                                                                                                                                                             #
#                                                                                                                                                                             #
#                                                                                                                                                                             #
#                                                                                                                                                                             #
#                                                                                                                                                                             #
#                                                                                                                                                                             #
#                                                                                                                                                                             #
#                                                                                                                                                                             #
#                                                                                                                                                                             #
#                                                                                                                                                                             #
#                                                                                                                                                                             #
#                                                                                                                                                                             #
#                                                                                                                                                                             #
###############################################################################################################################################################################
